Delal Abdullatif	Abzak
Fatma Özlem	Acar
Özde	Acarkan
Atahan	Adanır
Hacı Mehmet	Adıgüzel
Mükerrem Zeynep	Ağca
Bestami	Ağırağaç
Aykanat	Ağıroğlu
Şennur	Ağnar
Tutkum	Ahmadı Asl
Mügenur	Ahmet
Sevinç	Ak
Kayıhan Nedim	Akarcalı
Lemi	Akarçay
Cihan	Akarpınar
Rafi	Akaş
Mehmetcan	Akay
Nuhaydar	Akbilmez
Emine Münevver	Akca
Servet	Akçagunay
Çilem	Akçay
Recep Ali Samet	Akdoğan
Emre Ayberk	Akfırat
Kerime Hacer	Akıllı
Ercüment	Akıncılar
Sarper	Akış
Berker	Akkiray
İclal	Akkoyun
Lemis	Akküt
Ahmet Polat	Aklar Çörekçi
Ata Kerem	Akman
Ahmet Raşit	Akoğuz
Ecem Hatice	Akova
Nüket	Aksan
Senem	Aksevim
Ayşen	Aksoy
Pekcan	Aksöz
Bedirhan Lütfü	Akşamoğlu
Semina	Aktuna
Eda Sena	Akyıldız
Müyesser	Akyildirim
Selinti	Al
Bahar Özlem	Albaş
İlma	Aldağ
Kutlu	Alibeyoğlu
Nesibe Nurefşan	Alkan
Ömer Buğra	Alparslan
Hiba	Alpuğan
Mazlum	Altan
Elif Tuğçe	Altaş
Ahmet Ruken	Altay
Yaşar Utku Anıl	Altın
Rana	Altınoklu
Fethullah	Altınöz
Burak Tatkan	Altıntaş
Merve Ece	Altıok
Rima	Altıparmak
Elif Dilay	Altinkaya
Sırma Begüm	Altunbaş
Nefse	Altunbulak
Büşra Gül	Altundal
Erna	Aluç
Hikmet Nazlı	Alver
İsmail Umut	Anık
İlkay Ramazan	Ankara
Nebahat	Ansen
İlyas Umut	Apul
Halim	Aral
Yasin Şükrü	Arap
Cansev	Arat
Memet Ali	Ardıç
Deniz Dilay	Arıcan
İzlem	Arınç
Öget	Arif
Şeyda Nur	Arikan
Zeki Yiğithan	Armutcu
Nunazlı	Arpacı
Ferdacan	Aruca
Şerife	Asil
Mustafa Burhan	Askın
Ilım	Aslantürk
Sevginur	Aşcı
Hayrunnisa	Aşveren
Hanife Duygu	Ata
Sevtap	Atan
Paksoy	Ateş
İlkim	Ateşcan
Rubabe Gökçen	Atlı
Saba	Atmaca
Çisem	Atok
Sabiha Elvan	Atol
Edip	Attila
Almina	Avcı Özsoy
Saime	Avıandı
Nehar	Avşar
Kaan Muharrem	Ay
Murat Kaan	Ayanoglu
Murat Sinan	Ayaz
Ateş	Aycı
Zeynep Nihan	Aydınlıoğlu
Kerime	Aydoğan Yozgat
Hami	Aydoğdu
Thomas	Aygen
Güneş	Aykan
Elif Feyza	Ayrım
Uğur Ali	Aysal
Osman Yasin	Aysan
Adem	Ayvacık
Sera Cansın	Azbay
Ali İsmail	Babacan
Ruhugül	Babadostu
Alçiçek	Bad
Memet	Bağcı
Mercan	Bağçivan
Gökay	Bağış
Pırıltı	Bahçeli
Özgün	Bahtıyar
Özgen	Baka
Seung Hun	Baki
Gülser	Bal
Yüksel	Balcı
Ecren	Baldo
Muhammet Raşit	Balı
Sakıp	Balıoğlu
Kazım	Balta
Abdullah Atakan	Baluken
Coşkun	Baran
Serdar Kaan	Barbaros
Ezel	Bargan
Ayşegül	Barutçuoğlu
Sefa Kadir	Başar
Elif Etga	Başeğmez
Balın	Baştepe
Mahperi	Baştopçu
Erol Özgür	Baştuğ
Atak	Batar
Safa	Batga
Gökmen	Battal
Fazıl Erem	Batuk
Bensu	Batur
Nazım Orhun	Baturalp
Safa Ahmet	Baydar
Demircan	Baydil
Burçin Kübra	Baykal
Derviş Haluk	Baykan
Taylan Remzi	Baykuş
Abdulvahap	Bayrakoğlu
Aygün	Bayram
Ayla	Baytın
Kubilay Barış	Begiç
Mustafa Samed	Beğenilmiş
Berfin Dilay	Bekaroğlu
İbrahim Onat	Belge
Jutenya	Benan
Hulki	Bent
Mustafa Doğukan	Berberoğlu
Hüner	Berk
Buse Gizem	Berker
Halime	Beydağ
Didem	Bıçaksız
Mihrinaz	Bilal
Lal	Bilgeç
Senay	Bilgen
Remzi	Bilgi
Armağan	Bilgiç
Çelik	Bilgir
Kübra Tansu	Bilgit
Uluç Emre	Binbay
Mehmet Buğrahan	Birgili
Doğuşcan	Biriz
Altan	Boy
Bengisu	Boya
Onur Taylan	Boylu
Ayseren	Boyuktaş
Pekin	Boz
Aksu	Bozdağ
Arkan	Bozdemir
İltem	Boztepe
Betül	Bozyer
Ogün	Bölge
İbrahim Hakkı	Bugey
Onay	Buğdaypınarı
Cankız	Bulgan
Arzucan	Bulgur
Asiye	Burabak
Ahmet Yasin	Burak
Yaprak	Bural
Aleda	Buyuran
Can Güney	Bülbül
Mahmut Bilal	Bülend
Saliha Zeynep	Bülent
Melike Dilara	Büyükfırat
Hayriye	Büyükgüngör
Sebiha	Büyüköztürk
Mehmet	Can Akçaözoğlu
Mehmet Enes	Canan
Kurtbey	Canbağı
Mustafa Taha	Canbek
Sena Nur	Candan
Abdullah Emirhan	Caner
Mustafa Kerem	Cansu
Doktora	Canuyar
Seyit	Ceran
Selma Simge	Ceylan
Aşkım	Chiklyaukova
Özgür	Choi
Tuğce	Cibooğlu
Özer Seçkin	Ciddi
Balkın	Cigerlioğlu
Yücel	Civan
Şansal	Coşan
Oğuzcan	Coşandal
Mayıs	Cumalı
Büşra	Cüce
Afra Selcen	Çağan
Gönül	Çağatay
Doğangün	Çağlar
Elif Ege	Çağlayan
Özen	Çakan
Dilhan	Çakanel
Maral	Çakıcı
Mahire	Çalım
Hacı Bayram Ufuk	Çamaş